11111111100011111111
10000000000000000001
10200000000000000001
10000000000000000001
10000000003000000001
10000000000000000001
00000000011100000000
00000000011100000000
00000000011100000000
10000000000000000001
10000000000000000001
10000000000000000001
10000000000000000001
10000000000000000001
11111111100011111111
